0 0 0 0 0 0 0 0 0 0 0 0 0 0 0 0 0 0 0 0
0 0 0 0 0 0 0 0 0 0 0 0 0 0 0 0 0 0 0 0
0 0 0 0 0 0 0 0 0 0 0 0 0 0 0 0 0 0 0 0
0 0 0 0 20 0 0 0 0 0 0 0 0 0 0 0 0 0 0 0
0 0 0 0 0 0 0 0 0 0 0 0 0 0 0 0 0 0 0 0
0 22 0 0 18 0 18 0 17 0 18 0 17 0 17 0 18 0 0 0
0 0 0 0 19 0 19 0 19 0 19 0 19 0 19 0 19 0 0 0
0 0 0 0 17 0 17 0 17 0 18 0 18 0 18 0 18 0 0 0
0 22 0 0 19 0 19 0 19 0 19 0 19 0 19 0 19 0 0 0
0 0 0 0 18 0 18 0 17 0 18 0 17 0 17 0 18 0 0 0
0 0 0 0 19 0 19 0 19 0 19 0 19 0 19 0 19 0 0 0
0 22 0 0 17 0 17 0 17 0 18 0 18 0 18 0 18 0 0 0
0 0 0 0 19 0 19 0 19 0 19 0 19 0 19 0 19 0 0 0
