8 8 8 8 8 8 8 8 8 8 8 8 8 8 8 8 8 8 8 8
8 8 8 8 8 8 8 8 8 8 8 8 8 8 8 8 8 8 8 8
1 1 1 1 1 1 1 1 1 1 1 1 1 1 1 1 1 1 1 1
13 14 15 3 3 3 3 3 3 3 3 3 3 3 3 3 3 3 3 3
13 14 15 3 3 3 3 3 3 3 3 3 3 3 3 3 3 3 3 3
13 14 15 3 3 3 3 3 3 3 3 3 3 3 3 3 3 3 3 3
13 14 15 3 3 3 3 3 3 3 3 3 3 3 3 3 3 3 3 3
13 14 15 3 3 3 3 3 3 3 3 3 3 3 3 3 3 3 3 3
13 14 15 3 3 3 3 3 3 3 3 3 3 3 3 3 3 3 3 3
13 14 15 3 3 3 3 3 3 3 3 3 3 3 3 3 3 3 3 3
13 14 15 3 3 3 3 3 3 3 3 3 3 3 3 3 3 3 3 3
13 14 15 3 3 3 3 3 3 3 3 3 3 3 3 3 3 3 3 3


