2 2 2 2 2 2 2 7 7 7 7 7 7 2 2 2 2 2 2 2
8 8 8 8 8 8 8 6 6 6 6 6 6 8 8 8 8 8 8 8
1 1 1 1 1 1 1 5 5 5 5 5 5 1 1 1 1 1 1 1
0 0 0 0 0 0 4 4 4 3 3 3 0 0 0 0 0 0 0 0
0 0 0 0 0 0 4 4 4 3 3 3 0 0 0 0 0 0 0 0
0 0 0 0 0 0 0 0 0 0 0 0 0 0 0 0 0 0 0 0
0 0 0 0 0 0 0 0 0 0 0 0 0 0 0 0 0 0 0 0
0 0 0 0 0 0 0 0 0 0 0 0 0 0 0 0 0 0 0 0
0 0 0 0 0 0 0 0 0 0 0 0 0 0 0 0 0 0 0 0
0 0 0 0 0 0 0 0 0 0 0 0 0 0 0 0 0 0 0 0
0 0 0 0 0 0 0 0 0 0 0 0 0 0 0 0 0 0 0 0
0 0 0 0 0 0 0 0 0 0 0 0 0 0 0 0 0 0 0 0