2 2 2 2 2 2 2 2 2 2 2 2 2 2 2 2 2 2 2 2
8 8 8 8 8 8 8 8 8 8 8 8 8 8 8 8 8 8 8 8
1 1 1 1 1 1 1 1 1 1 1 1 1 1 1 1 1 1 1 1
0 0 9 3 3 3 3 3 3 3 3 3 3 3 3 3 3 3 3 3
12 12 11 3 3 3 3 3 3 3 3 3 3 3 3 3 3 3 3 3
12 12 11 3 3 3 3 3 3 3 3 3 3 3 3 3 3 4 0 0
12 12 11 3 3 3 3 3 3 3 3 3 3 3 3 3 3 10 12 12
12 12 11 3 3 3 3 3 3 3 3 3 3 3 3 3 3 10 12 12
12 12 11 3 3 3 3 3 3 3 3 3 3 3 3 3 3 10 12 12
12 12 11 3 3 3 3 3 3 3 3 3 3 3 3 3 3 10 12 12
12 12 11 3 3 3 3 3 3 3 3 3 3 3 3 3 3 10 12 12
12 12 11 3 3 3 3 3 3 3 3 3 3 3 3 3 3 10 12 12

