0 0 0 0 0 0 0 0 11 12 12 13 0 0 0 0 0 0 0 0
0 0 0 0 0 0 0 0 14 15 15 16 0 0 0 0 0 0 0 0
0 0 0 0 0 0 0 0 0 0 0 0 0 0 0 0 0 0 0 0
0 0 0 0 20 0 0 0 0 0 0 0 0 0 0 0 0 0 0 0
0 0 0 0 0 0 0 0 0 0 0 0 0 0 0 0 0 0 0 0
0 0 0 18 0 0 18 0 0 17 0 0 17 0 0 18 0 0 0 0
0 0 0 19 0 0 19 0 0 19 0 0 19 0 0 19 0 0 0 0
0 0 0 17 0 0 17 0 0 17 0 0 18 0 0 17 0 0 0 0
0 0 0 19 0 0 19 0 0 19 0 0 19 0 0 19 0 0 0 0
0 0 0 18 0 0 18 0 0 17 0 0 17 0 0 18 0 0 0 0
0 0 0 19 0 0 19 0 0 19 0 0 19 0 0 19 0 0 0 0
0 0 0 17 0 0 17 0 0 17 0 0 18 0 0 17 0 0 0 0
0 0 0 19 0 0 19 0 0 19 0 0 19 0 0 19 0 0 0 0
