2 2 2 2 2 2 2 2 2 2 2 2 2 2 2 2 2 2 2 2
8 8 8 8 8 8 8 8 8 8 8 8 8 8 8 8 8 8 8 8
1 1 1 1 1 1 1 1 1 1 1 1 1 1 1 1 1 1 1 1
11 3 3 3 3 3 3 3 3 3 3 3 3 3 3 3 3 3 3 3
11 3 3 3 3 3 3 3 3 3 3 3 3 3 3 3 3 3 3 3
11 3 3 3 3 3 3 3 3 3 3 3 3 3 3 3 3 3 3 3
11 3 3 3 3 3 3 3 3 3 3 3 3 3 3 3 3 3 3 4
11 3 3 3 3 3 3 3 3 3 3 3 3 3 3 3 3 3 3 10
11 3 3 3 3 3 3 3 3 3 3 3 3 3 3 3 3 3 3 10
11 3 3 3 3 3 3 3 3 3 3 3 3 3 3 3 3 3 3 10
11 3 3 3 3 3 3 3 3 3 3 3 3 3 3 3 3 3 3 10
11 3 3 3 3 3 3 3 3 3 3 3 3 3 3 3 3 3 3 10


