2 2 2 2 2 2 2 7 7 7 7 7 7 2 2 2 2 2 2 2
8 8 8 8 8 8 8 6 6 6 6 6 6 8 8 8 8 8 8 8
1 1 1 1 1 1 1 5 5 5 5 5 5 1 1 1 1 1 1 1
3 3 3 3 3 3 3 3 3 3 3 3 3 3 3 3 3 3 3 3
3 3 3 3 3 3 3 3 3 3 3 3 3 3 3 3 3 3 3 3
3 3 3 3 3 3 3 3 3 3 3 3 3 3 3 3 3 3 3 3
0 0 9 3 3 3 3 3 3 3 3 3 3 3 3 3 3 4 0 0
12 12 11 3 3 3 3 3 3 3 3 3 3 3 3 3 3 10 12 12
12 12 11 3 3 3 3 3 3 3 3 3 3 3 3 3 3 10 12 12
12 12 11 3 3 3 3 3 3 3 3 3 3 3 3 3 3 10 12 12
12 12 11 3 3 3 3 3 17 21 21 19 3 3 3 3 3 10 12 12
12 12 11 3 3 3 3 3 18 21 21 20 3 3 3 3 3 10 12 12